EA textures/resident_evil_gaiden_living_room.png
WE textures/resident_evil_gaiden_living_room.png
NO textures/resident_evil_gaiden_wall_lamp.png
SO textures/resident_evil_gaiden_wall_lamp.png

C 129,97,64
F 127,17,1

11111111111111111111111111111111111111111111111111111111111111
          101    1001     1001 1001   10000001     1001
         10001   10001    1000110001  101111001   1001
        1001001  101001   10100101001 1011  100111001
       100000001 1011001  1011000001  10001  1000001
     110011111001101 1001 10100101001 1011    11011
     1001     100101  1001100011011001101111   101
     1N1       10001   1000001 101 1000000001  101
11111111111111111111111111111111111111111111111111111111111111


