SO textures/bomberman_wall_normal.png
NO textures/bomberman_wall_desert.png
EA textures/bomberman_wall_normal.png
WE textures/bomberman_wall_desert.png

F 0,127,0
C 130,202,255

111111111111111111111111111111111111111111111111111111111111111
1000000000000000000000000000S0000000000000000000000000000000001
101010101010101010101010101010101010101010101010101010101010101
100000000000000000000000000000000000000000000000000000000000001
101010101010101010101010101010101010101010101010101010101010101
100000000000000000000000000000000000000000000000000000000000001
101010101010101010101010101010101010101010101010101010101010101
100000000000000000000000000000000000000000000000000000000000001
101010101010101010101010101010101010101010101010101010101010101
100000000000000000000000000000000000000000000000000000000000001
101010101010101010101010101010101010101010101010101010101010101
100000000000000000000000000000000000000000000000000000000000001
101010101010101010101010101010101010101010101010101010101010101
100000000000000000000000000000000000000000000000000000000000001
101010101010101010101010101010101010101010101010101010101010101
100000000000000000000000000000000000000000000000000000000000001
101010101010101010101010101010101010101010101010101010101010101
100000000000000000000000000000000000000000000000000000000000001
101010101010101010101010101010101010101010101010101010101010101
100000000000000000000000000000000000000000000000000000000000001
101010101010101010101010101010101010101010101010101010101010101
100000000000000000000000000000000000000000000000000000000000001
101010101010101010101010101010101010101010101010101010101010101
100000000000000000000000000000000000000000000000000000000000001
101010101010101010101010101010101010101010101010101010101010101
100000000000000000000000000000000000000000000000000000000000001
101010101010101010101010101010101010101010101010101010101010101
100000000000000000000000000000000000000000000000000000000000001
101010101010101010101010101010101010101010101010101010101010101
100000000000000000000000000000000000000000000000000000000000001
101010101010101010101010101010101010101010101010101010101010101
100000000000000000000000000000000000000000000000000000000000001
101010101010101010101010101010101010101010101010101010101010101
100000000000000000000000000000000000000000000000000000000000001
101010101010101010101010101010101010101010101010101010101010101
100000000000000000000000000000000000000000000000000000000000001
101010101010101010101010101010101010101010101010101010101010101
100000000000000000000000000000000000000000000000000000000000001
101010101010101010101010101010101010101010101010101010101010101
100000000000000000000000000000000000000000000000000000000000001
101010101010101010101010101010101010101010101010101010101010101
100000000000000000000000000000000000000000000000000000000000001
101010101010101010101010101010101010101010101010101010101010101
100000000000000000000000000000000000000000000000000000000000001
101010101010101010101010101010101010101010101010101010101010101
100000000000000000000000000000000000000000000000000000000000001
101010101010101010101010101010101010101010101010101010101010101
100000000000000000000000000000000000000000000000000000000000001
101010101010101010101010101010101010101010101010101010101010101
100000000000000000000000000000000000000000000000000000000000001
101010101010101010101010101010101010101010101010101010101010101
100000000000000000000000000000000000000000000000000000000000001
101010101010101010101010101010101010101010101010101010101010101
100000000000000000000000000000000000000000000000000000000000001
101010101010101010101010101010101010101010101010101010101010101
100000000000000000000000000000000000000000000000000000000000001
101010101010101010101010101010101010101010101010101010101010101
100000000000000000000000000000000000000000000000000000000000001
101010101010101010101010101010101010101010101010101010101010101
100000000000000000000000000000000000000000000000000000000000001
101010101010101010101010101010101010101010101010101010101010101
100000000000000000000000000000000000000000000000000000000000001
111111111111111111111111111111111111111111111111111111111111111
