C 130,202,255
F 0,127,0

NO textures/minecraft_diamond.png
SO textures/minecraft_gold.png
WE textures/minecraft_emerald.png
EA textures/minecraft_iron.png

1111111111111111111
1000000000000000001
1000000000000000001
1000000000000000001
1000000000000000001
1000000000000000001
1000000000000000001
1000000000000000001
1000000000000000001
1000000000000000001
1000000000000000001
1000000000000000001
1000000000000000001
10000000000E0000001
1000000000000000001
1000000000000000001
1000000000000000001
1000000000000000001
1000000000000000001
1000000000000000001
1000000000000000001
1000000000000000001
1000000000000000001
1111111111111111111