C 130,202,255
F 255,255,255

NO       textures/fern_north.png
SO        textures/fern_south.png
WE ./textures/fern_west.png
EA ./textures/fern_east.png

111111111111111111111111
100000000000000000000001
100000000000000000000001
100000000000000000000001
100000000001111100001001
100000001000010000000001
100000001000010001000001
100000001000010000000001
100000001111011100001001
100000000000000000000001
100000000000000000000001
100000000000000000000001
100000000000S00000000001
100000000000000000000001
100000000000000000000001
100000000000000000000001
100000000000000000000001
100001111111111100000001
100100100000000100000001
100100001001000100000001
100100100000000100000001
100101111111111110000001
100100000000000000000001
111111111111111111111111
